$$$ exec p1 : [players/filler]
Plateau 15 17:
    01234567890123456
000 XXXXXXXXXXXXXXXX.
001 XXXXXXXXXXXXXXXX.
002 XXXXXXXXXXXXXXXX.
003 XXOOOXXXXXXXXXXX.
004 XXOOOOOXXXXXXXXX.
005 XOOOOOOOOXXXXXXX.
006 OOOOOOOOOOXXXXXX.
007 OOOOOOOOOOOXXXXX.
008 OOOOOOOOOOOOOXXX.
009 OOOOOOOOOOOOOXXX.
010 OOOOOOOOOOOOOXX..
011 OOOOOOOOOOOOOX...
012 OOOOOOOOOOOOXXX..
013 oOOOOOOOOOOOO....
014 o....O..O........
Piece 9 1:
.
*
*
*
*
.
.
.
.